25 15
$************************
**##########*############
############*############
############*############
############*############
############*############
############*############
############*############
*************************
############*############
############*############
############*############
############*############
############*#########***
############***********^B
